0 0 8192 8192 0
1 0 8192 4096 4096
3 0 4096 4096 0
25 0 4096 2048 2048
27 0 2048 2048 0
217 0 2048 1024 1024
219 0 1024 1024 0 0 1 2 3 4 5 6 7 8 9 10 11 12 13 14 15 23 24 25 26 27 60 61 62 65 66 67 68 69 70 84 85 86 95
218 1024 2048 2048 1024
220 1024 1024 2048 0 15 16 17 18 19 20 21 22 28 29 30 31 32 33 34 35 36 37 38 39 40 41 42 63 64 87 88 89 90 118 120 121 122 123 124 125 127 128 129 130
26 2048 4096 4096 2048
28 2048 2048 4096 0
225 2048 2048 3072 1024
227 2048 1024 3072 0 42 43 44 45 46 47 48 49 50 51 52 53 54 55 56 57 58 59 71 72 73 83 91 92 96 97 119 126
226 3072 2048 4096 1024
228 3072 1024 4096 0 73 74 75 76 77 78 79 80 81 82 93 94 98 99 100 101 102 103 104 105 106 107 108 109 110
2 4096 8192 8192 4096
4 4096 4096 8192 0
33 4096 4096 6144 2048
35 4096 2048 6144 0
281 4096 2048 5120 1024
283 4096 1024 5120 0 109 110 111 112 113 114 115 116 117 131
282 5120 2048 6144 1024
284 5120 1024 6144 0
34 6144 4096 8192 2048
36 6144 2048 8192 0
<End>
