0 0 16384 16384 0
1 0 16384 8192 8192
3 0 8192 8192 0
25 0 8192 4096 4096
27 0 4096 4096 0
217 0 4096 2048 2048
219 0 2048 2048 0
1753 0 2048 1024 1024
1755 0 1024 1024 0 0 1 2 3 4 5 6 7 8 9 10 11 12 13 14 15 16 17 18 19 20 214 215 216 217 218 219 220 221 222 354 355 378 379
1754 1024 2048 2048 1024
1756 1024 1024 2048 0 20 21 22 23 24 25 26 27 28 29 30 31 32 33 34 35 36 37 38 39 40 220 223 224 225 226 227 228 229 230 231 232 233 234 242 244 268 356 357
218 2048 4096 4096 2048
220 2048 2048 4096 0
1761 2048 2048 3072 1024
1763 2048 1024 3072 0 40 41 42 43 44 45 46 47 48 49 50 51 52 53 54 55 56 57 58 234 235 236 237 238 239 240 241 243 245 246 264 358 359 360
1762 3072 2048 4096 1024
1764 3072 1024 4096 0 59 60 61 62 63 64 65 66 67 68 69 70 71 72 73 74 75 76 77 247 248 249 250 251 252 253 254 255 256 257 258 259 260 261 262 263 265 266 267 269 361 362 363
26 4096 8192 8192 4096
28 4096 4096 8192 0
225 4096 4096 6144 2048
227 4096 2048 6144 0
1817 4096 2048 5120 1024
1819 4096 1024 5120 0 77 78 79 80 81 82 83 84 85 86 87 88 89 90 91 92 93 94 95 96 97 98 265 270 271 272 273 274 275 276 277 278 279 363 364 365
1818 5120 2048 6144 1024
1820 5120 1024 6144 0 98 99 100 101 102 103 104 105 106 107 108 109 110 111 112 113 114 115 280 281 282 283 284 285 286 287 288 289 290 295 296 297 298 304 366 367
226 6144 4096 8192 2048
228 6144 2048 8192 0
1825 6144 2048 7168 1024
1827 6144 1024 7168 0 115 116 117 118 119 120 121 122 123 124 125 126 127 128 129 130 131 132 133 134 135 136 290 291 292 293 294 299 300 301 302 303 305 307 308 309 310 311 312 313 323 368 369
1826 7168 2048 8192 1024
1828 7168 1024 8192 0 136 137 138 139 140 141 142 143 144 145 146 147 148 149 150 151 152 153 154 155 156 306 314 315 316 317 318 319 320 321 322 370 372
2 8192 16384 16384 8192
4 8192 8192 16384 0
33 8192 8192 12288 4096
35 8192 4096 12288 0
281 8192 4096 10240 2048
283 8192 2048 10240 0
2265 8192 2048 9216 1024
2267 8192 1024 9216 0 156 157 158 159 160 161 162 163 164 165 166 167 168 169 170 171 172 173 174 175 176 177 324 325 326 327 328 329 330 331 332 333 371 373
2266 9216 2048 10240 1024
2268 9216 1024 10240 0 177 178 179 180 181 182 183 184 185 186 187 188 189 190 191 192 193 194 195 196 197 334 335 336 337 338 339 340 341 342 343 344 345 346 347 348 349 350 351 352 374 375 380 381
282 10240 4096 12288 2048
284 10240 2048 12288 0
2273 10240 2048 11264 1024
2275 10240 1024 11264 0 197 198 199 200 201 202 203 204 205 206 207 208 209 210 211 212 213 353 376 377 380
2274 11264 2048 12288 1024
2276 11264 1024 12288 0
34 12288 8192 16384 4096
36 12288 4096 16384 0
<End>
