0 0 8192 8192 0
1 0 8192 4096 4096
3 0 4096 4096 0
25 0 4096 2048 2048
27 0 2048 2048 0
217 0 2048 1024 1024
219 0 1024 1024 0 0 1 2 3 4 5 6 7 8 9 10 11 12 13 14 15 16 22 23 24 25 26 58 59 60 62 63 64 65 66 67 81 82 83 92 129 130 131 132 133 134 209 210
218 1024 2048 2048 1024
220 1024 1024 2048 0 16 17 18 19 20 21 27 28 29 30 31 32 33 34 35 36 37 38 39 40 41 42 61 84 85 86 87 115 117 118 119 120 121 122 124 125 126 127 209 210 211 212
26 2048 4096 4096 2048
28 2048 2048 4096 0
225 2048 2048 3072 1024
227 2048 1024 3072 0 42 43 44 45 46 47 48 49 50 51 52 53 54 55 56 57 68 69 70 80 88 89 93 94 116 123 135 136 137 138 139
226 3072 2048 4096 1024
228 3072 1024 4096 0 70 71 72 73 74 75 76 77 78 79 90 91 95 96 97 98 99 100 101 102 103 104 105 106 107 177 178 179 180 181 182 183 184 185 213
2 4096 8192 8192 4096
4 4096 4096 8192 0
33 4096 4096 6144 2048
35 4096 2048 6144 0
281 4096 2048 5120 1024
283 4096 1024 5120 0 107 108 109 110 111 112 113 114 140 141 142 143 144 145 146 147 148 149 150 151 152 153 186 187 188 189 190 191 192 193 194 195 196 204 205 206 207 208 214 215
282 5120 2048 6144 1024
284 5120 1024 6144 0 128 153 154 155 156 157 158 159 160 161 162 163 164 165 166 167 168 169 170 171 172 173 174 196 197 198 199 200 201 202 203
34 6144 4096 8192 2048
36 6144 2048 8192 0
289 6144 2048 7168 1024
291 6144 1024 7168 0 128 174 175 176
290 7168 2048 8192 1024
292 7168 1024 8192 0
<End>
